
We know that rumination (dwelling on personal problems) and social isolation are common features of depression. However, we don't know whether these findings reflect differences in attention or thinking style. Does depression cause people to focus on themselves, or do people who focus on themselves get symptoms of depression?
=> https://www.nzherald.co.nz/lifestyle/news/article.cfm?c_id=6&objectid=11989164
벡 절망 척도로 가벼운 우울증 테스트가 가능

운동 중 다쳤을때, 인지하지 못하는;

borderline personality disorder = 경계성인격 장애, 자아상 및 대인관계가 불안정하고
충동적이고 자기파괴적인 행동이 자주 있고 분노조절이 안되고 자살위험이 있다.
thematic = 주제의, 주제와 관련된
dichotomous= 양분된, 2분법의 /두 갈래로 갈라진
cognitive rigidity = 인지적 경직성
anorexia = 신경성식욕부진증, 거식증
relapse = 병의 재발 / (안 좋은 상태로) 다시 나빠지다
dogmatism = 독단주의 / 교조주의 (= 과학적인 해명없이 신앙, 신조에 입각하여 교리를
				 	주장하는 입장)
advent= 도래/ 출현
narrative = 묘사, 서술(기법)
glean = (정보, 지식등을 어렵게) 얻다
schizophrenia = 조현병(정신이상, 정신분열)
cognitive vulnerability = 인지 취약성
persist = 집요하게 계속하다 / (없어지지 않고) 계속되다
from the outset = 처음부터/ 처음에
devoid = ~이 전혀 없는
valence = 원자가(?)
obscure = 잘 알려져 있지 않은/ 이해하기 힘든, 모호한 / 모호하게 하다.
endeavor = 노력, 시도, 애씀/ 노력하다, 시도하다
account for = ~을 설명/해명하다 / (부분 비율을) 차지하다
negation = (~의 정반대); (존재에 대한) 부정/ 반대, 부인, 거부
salutation = 인사, 인삿말
residual = (어떤 과정이 끝나고 난 뒤에)남은, 잔여의
skew = 왜곡하다, 비스듬히 움직이다.
strata = stratum의 복수형 = (사회)계층, (암석 등의) 층, 지층, 단층
prevalence =  출현율, 유병률/ 널리 퍼짐, 유행, 보금
hoc = this = 이, 이것
indices = index의 복수
per se = 그 자체가, 그 자체로는	
post hoc = 사후분석
unconventiona = 인습에 얽메이지 않는, 색다른, 독특한
corpus = 말뭉치 
trait-like = 특성유사, 속성적인
abate = (강도가) 약해지다; 약화시키다
reaffirm = 재확인하다
akin = ~와 유사한
confirmatory = 확실하게 하는, 확증적인
morbid = (질병 죽음에 대한 관심이)병적인, 병과 관련된, 병의
comorbid = 동시이환, 동반이환
disposed = ~할 마음이 있는 
dispose = (특정 방식,위치에 물건이나 사람을)배치하다, ~에게 ~의 경향을 갖게 하다
vague = (기억 등이)희미한, 모호한, 애매한, 멍청한, 얼빠진 것 같은
predispose = ~를 하게 만들다, ~하는 경향을 갖게하다
maladaptive = 순응성이 없는, 부적응의
anecdotal = 입증되지 않은, 일화적인
primacy = 최고, 으뜸 / 대주교의 지위
cultivate = (땅을)격작하다, 일구다, 재배하다, (관계를) 구축하다
purport = (사실이 아닌수도 있는 것을)주장하다/ 전반적인 뜻, 요지
manipulation = 교묘한 처리, 솜씨 있는 취급/ 시장조작, 조작된 가격, 조작, 속임수
vulnerability factor = 취약인자
elevated = (지위가)높은, 고상한
posttraumatic stress disoder = 외상후 스트레스장애
dominance = 우월; 권세; 지배; 우세/ (생물,심리) 우성
medium = (대중 전달용)매체, (특정한 목적을 위한)도구
usher st in = ~이 도입[시작]되게 하다. / usher = 안내하다
psychometric = 정신력 측정용의
inkblot = (심리 테스트용)잉크 얼룩
apperception = 통각(작용); 이해
affiliation =  (개인의 정치, 종교적)소속/ (단체의)제휴, 가맹
intercorrelation = 급간상관(몇몇 변수들 상호간의 상관관계)
redundant = 불필요한, 쓸모없는 /(일거리 부족으로)정리 해고당한
devise = 창안하다
intertwine = 뒤얽히다, 뒤얽다, 엮다, 엮이다 / 밀접하게 관련되다
convey = (생각등을)전달하다/ 운반하다, 나르다
esoteric = 소수만 이해하는 / 비전의
referent = (단어의) 지시 대상(물); 관계항 / 관계있는, 언급한(to)
psychiatric = 정신 의학의
impairment = (신체적, 정신적)장애
prescient = 선견지명이 있는
upheaval = 격변, 대변동
coherent = 일관성 있는, 논리 정연한/ 조리 있게 말하는
ever-changing = 지속적으로 변화하고 발전하는
inquiry = 연구,탐구 / 조사, 취조, 심리 / 질문, 문의, 조회 (about)
modest = 겸손한 / (크기, 가격, 중요성 등이)그다지 대단하지 않은, 보통의
subjective = 주관적인/ 마음속에 존재하는/ 주격의
thesaurus = 유의어 사전
streamline = (시스템, 조직등을)간소화 하다/ 유선형으로 하다.
assortment = (같은 종류의 여러 가지)모음, 집합
assertion = (사실임을) 주장, (권리 등의)행사
enthrall = 마음을 사로잡다
hold out st = ~의 가능성을 보이다/ (어려운 상황에서)지속되다, 저항하다
utterance = (말로)표현함, 입 밖에 냄 / 발언
oscillate = (감정,행동이 양극을)계속 오가다/ 진동하다, (두 지점 사이를) 왔다 갔다 하다
superficial = 깊이없는, 얄팍한/ 피상적인/ 깊지 않은, 표피상의
perpetrator = (범행, 과실, 악행을 저지른) 가해자
undisclosed = 밝혀지지 않은, 비밀에 부쳐진
immersion = 몰두, 몰입/ (액체 속에) 담금
deceptive = 기만적인, 현혹하는
assent = 찬성, 승인 / 찬성하다
cue = (무엇을 하라는) 신호
first lieutenant = (해군) 갑판사관 / (육군,공군의)중위/ 두번째로 가장 소중한 사람
cohesion = 화합, 결합 / 응집력
resenment = 분함, 억울함, 분개
obsessive-compulsive = 강박(신경증)의, 강박적인 / 강박 신경증 환자
agoraphobia = 광장 공포증
coordination = 조직(화), 합동, 조화
appraisal = (가치, 업적, 본질에 대한)평가/ (업무)평가회
construal = construe 의 형용사 = ~을 (~으로) 이해하다
presumably = 아마, 짐작컨대
manifestation = (어떤 것이 존재하거나 일어나고 있음을 보여주는)징후, (유령, 영혼의) 나타남
extraversion = 외향성, 외향의
predilection = (~을) 매우 좋아함
contrived = 억지로 꾸민 듯한, 부자연스러운
transcribe = (생각이나 말을) 글로 기록하다
increment = (수, 양의) 증가, (정기적인) 임금 인상
asterisk = 별표(*)
affective =  정서적인
discrepancy  = (같아야 할 것들의)차이 [불일치]
cronbach alpha = 시험 문제의 일관성을 나타내는 계수로 0과 1사이의 값을 가지면 1의 가까울 수록 신뢰성이 높다.
amass = 모으다, 축적하다
discrimination = 차별
stringent = 엄중한/ 긴박한, 절박한
transient = 일시적인, 순간적인
intricate = (여러 부분, 내용으로 되어 있어) 복잡한
stark = (흔히 못마땅함)(아무 색채나 장식이 없어) 삭막한[황량한]
steer = 조종하다/ (특정 방향으로)움직이다[나아가다]
repertoire = 레파토리
scrunch up = (얼굴을) 찡그리다, 찡긋거리다
manifest = (특히 감정,태도,특질을 분명히)나타내다[드러내 보이다]/ 나타나다, 분명해지다/분명한
rule of thumb = 경험 법칙, 어림 감정/ 경험에서 도출된 수단이나 방침
precipitously = 험하게,가파르게 / 무분별하게/ 급하게
prose = 산문
upshot = 결과, 결말
modality = 양식, 양상
scale = 등급, 규모, 계층구조
morphological = 형태학(상)의
elicit = (정보, 반응을 어렵게) 끌어내다, 유도하다
recurring = 되풀이하여 발생하는, 순환되는
disentangle = (혼란스러운 주장, 생각 등을)구분하다, 혼란을 수습하다, 갈등을 해소하다
self-reference = 자기 자신에 관한 언급
criterion = 기준, 척도
colloquial = 일상적인 대화체의, 구어의
hedge = 얼버무리다/ ~을 둘러싸다.
evidential = 증거에 입각한/ 증거가 되는 
detachment = 무심함, 거리를 둠 / 객관성, 공펴엉
impose = 도입하다, 시행하다/ 강요하다
deliberation = 숙고,숙의/ 신중함
deliberate = 고의의
subordination = 종속, 순종/ 예속시킴, 종속시키기 / 경시
nominalization = 명사화
attribute = ~을 ~의 결과로[덕분으로] 보다 / 속성, 특질
demand = 수요/ (어렵거나 힘이 드는) 일[부담]/ 요구(사항)
morphosyntactic = 통사형태론적인
discursive = (글이나 말이) 두서없는, 산만한
substantiate = (격식) 입증하다
faculty = 교수요원들 / (사람이 타고나는 신체적, 정신적) 능력, 기능
overtly = 명백히, 공공연하게
induce = 설득하다, 유도하다 / 유발[초래]하다
call for = ~을 필요로 하다. ~을 요청하다 / 큰소리로 부르다
room and board = 식사를 제공하는 하숙[요금]
respiratory = 호흡의, 호흡 기관의
contour = (사물의) 윤곽/ 등고선
participle = 분사
forth = ~에서 멀리 ; 밖으로
and so forth = ~등등, ~따위
invoke = (법, 규칙 등을) 들먹이다[적용하다]/언급하다/ (느낌, 상상을) 불러일으키다/ (프로그램 등을) 불러오다.
omission = 생략/ 빠짐, 누락
genitive = 소유격
omit = 빠뜨리다, 누락[제외]시키다/ 생략하다. 
status = 중요도/ (진행 과정상의)상황
diffuse = 널리 퍼진, 분산된
pragmatic = 실용적인
improvise = (있는 것으로) 처리하다/ 즉석에서 처리하다
pose = (위험, 진지한 질문 등을) 제기하다
proxy = 대리, 대리인/ 위임[권]
slouch = (게으르게) 구부정하니 서다/ 구부정한 자세
arsenal = (집합적)무기 / 무기 공장, 무기고
counterproductive = 역효과를 낳는
functional account = 기능론적
explicit = 명쾌한, 분명한/솔직한, 터놓고 말하는/ 노골적인, 명백한
attributive = 한정 용법으로 쓰인(명사 앞에서 그것을 수식하는)
probing = 추가질문/ 진실을 캐기위한, 면밀히 살피는
orthogonal = 수직의, 직교의
phonology = (특정 언어의) 음운 체계; 음운론
take st into account = st을 고려하다
addressee = 수신인
dichotomous = 양분된; 2분법의 / (가지, 잎이) 두 갈래로 갈라진 
deficit = 적자/ 부족액, 결손
dogmatism = 독단(적인 행동이나 태도)
autobiographical = 자서전(체)의
cognitive rigidity = 인지적 경직성
inherent = 내재하는
compel = 강요하다; (필요에 따라)~하게 만들다/ (어떤 반응을)자아내다
compelling evidence = 유력한 증거
flounder = (어쩔 줄 몰라서) 허둥대다 / (곤경에 처해) 허우적거리다
sheer = 순전한/ (다른 것이 섞이지 않아) 순수한
unwieldy = (크기, 모양, 무게 때문에)다루기 불편한 / (너무 크거나 복잡해서) 통제하기 힘든
refer to = ~을 나타내다/ ~을 언급하다 / ~을 참조하다
refer to as = ~라고 언급하다
inflection = (단어, 언어의) 굴절 / 억양, 어조
constituent = (특정 선거구에 사는)주민/ 구성 성분/ ~을 구성하는
hail from = ~출신이다 / ~에서 태어났다
hail = (신문 등에서 아주 훌륭하거나 특별한 것으로) 묘사하다, 일컫다 / (택시, 버스 등에) 신호를 보내다 / (사람에게) 소리치다, 부르다 / 우박이 쏟아지다
detrimental = 해로운
overarching = (많은 것에 관련되므로) 대단히 중요한
retain = (계속) 유지하다, 보유하다
constitute = ~이 되는 것으로 여겨지다, ~이 되다 / ~을 구성하다
refinement = (작은 변화를 통한) 개선, 개량
negligibly = 무시할 수 있게, 사소하게
clout = 영향력/ 쎄개 때리다, 강타하다
jarring = 삐걱거림, 부조화, 충돌
substantially = 상당히, 많이 
interrogative = (격식) 질문하는, 물어보는, 질문 형태의
staple = 주된, 중요한
select = 엄선된, (상류층이 이용하는) 고급의
due = (격식) 적절한, 마땅한
psychiatric = 정신 의학(질환)의 
repository = 저장소, 보관소
rumination = 반추 / 심사 숙고 / 숙고의 결과
onset = (특히 불쾌한 일의) 시작
clinical = 임상의 / 냉담한 / 간소한, 꾸밈 없는
ensemble = (소규모의) 합주단, 앙상블 / 총체
pruning = (나무등의) 가지치기 / (필요 없는 것을) 쳐내기, 축소하기
novel = 소설 / 새로운, 참신한, 신기한
feasibility = 실행할 수 있음, 실행(가능성)
formant = 포먼트 / 모음 구성의 음소 / 형성음
jitter = 안달하다, 안절부절 못하다 / 신경질적으로 행동하다 / 덜덜 떨다 / 조금씩 움직이다.
shimmer = 희미하게 빛나다, (빛을 받아) 아른거리다 / (일렁이는 듯한) 희미한 빛
spectral = 스펙트럼의 / 유령 같은, 유령의
glottal = 성문음의 (성대와 관련된 소리인 듯 )
testify = (특히 법정에서) 증언하다 / 증명하다 / 신앙 간증을 하다
remorseful = 후회하는, 양심의 가책을 받는 / 후회의, 후회에 의한
remorse = 회한
ambient = 주위의 / 잔잔한, 은은한
et al. = and others
contingency = 만일의 사태 / 우연성
booklet = 작은 책자 / 소책자
demographic = 인구 (통계)학의
high-risk people = 고위험군의 사람들
lactate = 젖을 분비하다
phonetic = 음성을 나타내는 / 표음식의 / (사람) 음성의
multilingual = 여러 언어를 하는 / 여러 언어로 쓰인
extremum = (함수 등의) 극값
apperception = 통각(작용) / 이해, 유화
manually = 손으로 / 수공으로
supplement = 보충하다, 추가하다 / 보충(추가)물, 부록 / 추가요금
criterion = (판단이나 결정을 위한) 기준, 척도
relevance = (표현 등의) 적절, 타당성 ; (당면 문제와의) 관련성
ontology = 존재론
pharmacological = 약학의, 약물학의, 약학상의, 약학적인
psychomotor = 정신운동의, 정신운동성 / 대뇌의 활동 또는 정신활동의 운동효과에 관한 것
agitation = 불안, 동요 / (정치적) 소요, 시위 / (액체를) 휘저어 섞음, 교반
retardation = 지연; 저지, 방해; 지체(방해)량 / (물리) 감속도 ; 방해물
anhedonia = (성)쾌감 상실 / 쾌락 불감증, 무쾌감증
ischaemia = 국소빈혈
prolong = 연장시키다, 연장하다
complement = 보완하다, (금상첨화 격으로) 덧붙이다 / 보완물 / 보어
multimodal = 다양한 / (통계) 다모드의
adopt = 채택하다/ ~을 사용하다, 취하다 / 입양하다
feed st to st2 = st2에 st을 먹이다, 넣다
hereafter = 이후로, 이후 내용에서 / 장차 / 내세, 사후세계
endo = (약제학) 내, 안의
kernel = 핵심, (견과류) 알맹이
paralinguistic = 준언어적인(말이 아니라 어조, 표정, 동작 등으로 의사소통을 하는 것과 관련된 것)
span = (어떤 일이 지속되는) 기간[시간]/ 폭[범위]; 다양성 / (얼마의 기간에) 걸치다, 걸쳐 이어지다 / (넓은, 많은 것들을) 걸치다[포괄하다] / 가로지르다
offset = 상쇄[벌충]하다
distill = 증류하다/ ~을 증류하여 ~으로 만들다/ 불순물을 제거하다
latent = 잠재하는, 잠복해 있는
gist = (말, 글, 대화의)요지 [골자]
disposition = (타고난) 기질, 성격 / 배치, 배열 / (재산의) 양도
if any = 만약에 있다면; 만약에 [설사] 있다손 치더라도
legend = (지도, 도표 등의)범례
sigmoid = S자 모양
gradient = 경사도 / (온도, 기압 등의) 변화도
ipersomnia = hypersomnia = 너무 많이 자는 병 insomnia 반대
make use of = ~을 이용[활용]하다
dysregulate = 메카니즘(조절 기제)의 정상적인 작용을 방해함으로써 유기체의 화학적인 또는 활성 레벨에 부작용을 일으키는 것
dysfunctional = 제대로 기능을 하지 않는, 고장난
populate = 살다, 거주하다 / 이주시키다[하다] / (서류에 데이터를) 덧붙이다
deposition = 퇴적, 퇴적물 / (통치자를) 물러나게 함[퇴위/폐위(시킴)]
mutate = 돌연변이가 되다; 돌연변이를 만들다 / (새로운 형태로) 변형되다.
efficacy = (특히 약이나 치료의) 효험
pitfall = (눈에 잘 안띄는) 위험
somatic = 신체의, 육체의 / 체강의
aberration = 일탈; 일탈적인 행동
suppressor = 억압유전자 : 어떤 형질의 발현을 억제하도록 작용하는 돌연변이 유전자
oncogene = 종양 (형성) 유전자
prostate = 전립선
pediatric = 소아과(학)의
phenotype = 표현형 (유전자와 환경의 영향에 의해 형성된 생물의 형질)
ontology = 존재론 / (언어로 표현된 개념 간 연관 관계 지식이 드러나는) 망
annotation = 주석(을 달기)
motif = (장식용) 디자인 / (문학, 음악 작품 속에서 반복, 전개되는) 주제
proteome = (유전) 단백질 유전 정보
compilation = 모음집[편집본] / 편집, 편찬
morbidity = (정신의) 병적 상태, 불건전 / (어떤 병의) 사망률 / (특정 지구의) 질병률
regulatory = 규제[단속]력을 지닌
aberrant = 일탈적인, 도리를 벗어난
coordinate clause = 등위절(and, or ,but)
compound clause = 중문 : 절을 등위접속사로 이은 문장
complex clause = 복문 : 최소 한개의 주절과 종속절을 가진 문장
profound = (영향, 느낌, 경험 등이) 엄청난/ (지식, 이해 등이) 깊은/ (질문 등이)심오한
alembicate = (증류기로) 증류하다 / (엑스가 될 때까지)정제하다
stint = 일정 기간 동안의 일활동 / 아끼다, 인색하게 쓰다
ascribe = (원인, 동기, 기원 등을) ~에 돌리다(attribute), (결과 등을) ~의 탓으로 돌리다(impute)
premenstrual = 월경 전의
demarcation = 경계; 구분
praecox = 조숙의, 일찍 익은, 일찍 꽃피는
anthropomorphism = 의인화 / 신인 동형론 / 의인관
amygdala = 편도체
dilute = 희석하다, 묽게하다 / (효과 등을) 희석시키다/ 희석된
synesthesia = 공감각(하나의 감각이 다른 감각을 작용케 하는 일) / 공감
idiosyncratic = (개인에게) 특유한(peculiar) ; 기이한, 색다른 / 특이 체질의
saturation = 포화(상태), 포화도 / 채도
invariance = 불변(성)
hue = 빛깔, 색조 / (신념 등의) 색깔
analogous = 유사한
ordinal = 서수 (첫째, 둘째 등과 같은 수)
synthetic = (인위적으로)합성한, 인조의 / 종합적인 / 인조 물질
concoction = (특히 음료나 약물의 특이한) 혼합물
whiff = (잠깐 동안) 훅 끼치는 냄새 / (약간의) 조짐/ (공을) 헛침
visceral = (깊은 사고가 아니라) 강한 감정에 따른, 본능적인 / 내장의
olfactory = 후각의
peripheral = (중요하지 않은) 주변적인, 지엽적인 / 말초의 ; 주변부의
substrate = 기질(결합 조직의 기본 물질)
odorant = (도시 가스 등에 첨가하는) 취기제, 착취제 / 후각자극제, 후각을 자극할 수 있는 물질
ipsilateral = (신체의) 동측(성)의 / 같은 쪽의
projection = 투사, 투영, 영사 / (현 상황을 근거로 한 규모, 비용, 양 등의)예상
cortical = 피층의; 피질의, 외피의 / 대뇌 피질성의
thalamus = 시상
transduction = 형질 도입(bacteriophage를 매개로 하여 세균 DNA가 다른 세균으로 이동되는 현상) / (에너지 등의) 변환
unmyelinated = 무수초의(마이엘린 껍질을 갖지 않는 신경 섬유를 지칭하는 말)
axon = (신경 세포의) 축색 돌기, 축삭돌기
induce = 설득하다, 유도하다 / 유발하다 / (약을 써서)분만을 유도하다
insurmountable = 대처할 수 없는
lateralization = (대뇌의)좌우의 기능 분화, 편재화(특정 기능이 좌반구와 우반구 중 어느 한쪽에 치우쳐 있는 것)
hedonic = 쾌락의, 향락적인 / 쾌락설의
enology = 양조학 / 포도주학
gustatory = 맛의, 미각의
obscure = 잘 알려져 있지 않은, 무명의 / 이해하기 힘든, 모호한 / 보기 어렵게 하다, 모호하게 하다
opaque = 불투명한 / 이해하기 힘든
impasse = 교착상태
postulated = (이론 등의 근거로 삼기 위해 무엇이 사실이라고) 상정하다 / 상정
enunciate = (또렷이)말하다 / (생각을 명확히) 밝히다
psychophysical = 정신신체적인, 마음과 신체현상의 관련에 관해서 / 정신물리학의
precede = ~에 앞서다 / ~앞에 가다
chemosensorial = 화학적 감각의
draw up = (세심한 생각, 계획이 필요한 것을) 만들다, 작성하다 / (차량이)다가와서 서다
referent = (단어의) 지시 대상(물) ; 관계항 / 관계있는, 언급한(to)
enunciator = 선언자 ; 발음자
discursive = 두서없는, 산만한
skirt = (가장자리를)두르다(둘러 가다)/ (특히 곤란한 주제에 대해) 언급을 피하다/ 실험등에서 의도적으로 다른 답을 내놓다.
thereof = (앞에 언급된) 그것의
exert = (권력, 영향력을) 가하다(행사하다) / 있는 힘껏 노력하다, 분투하다
mnesic = 기억과 연관 있는
cerebral = 뇌의, 뇌와 연관있는 / 지적인, 이지적인
convergence = 한 점으로 집합함, 집중성 / 수렴
anterograde = (의학) 선행, 앞방향, 제방향, 전방으로 움직이는, 전방으로 뻗는
retina = (눈의) 망막
macaque = 마카크(짧은 꼬리 원숭이)
orbitofrontal = (실험심리학) 안와 전두 피질
cuneus = (해부)설상엽 : 대뇌 후두엽의 중앙에 있는 설상뇌 회전부
correspondence = (A와 B의) 관련성 / (남과 주고받는) 서신/ 편지쓰기
cross-modal = 2감각 통합의 / 교차 양상(서로 다른 감각 양상에 걸쳐서 발생하는 경우)
arise = 생기다, 발생하다 / (무엇의 결과로)유발되다 / 발달하기 시작하다
stem from st = ~에서 생겨나다(기인하다)
congruent = 알맞은, 적절한 / 크기와 형태가 동일한, 합동의
representational = 구상주의적인 / 대의의 / 표상 체계 (system)
emerge = (어둠 속이나 숨어 있떤 곳에서)나오다 / 드러나다, 알려지다 / 생겨나다, 부상하다
idiosyncratic = (개인에게) 특유한(peculiar) ; 기이한, 색다른 / 특이 체질의
underlying = (겉으로 잘 드러나지는 않지만) 근본적인 / (다른 것의) 밑에 있는
likely = 그럴듯한, 그럴싸한 / ~할 공산이 있는, ~할 것 같은
predominant = 두드러진, 뚜렷한 / 우세한, 지배적인
spatial = 공간의, 공간적인
univariate = 일도량의, 분포가 변량이 하나인/ 단변량
ethnicity = 민족성
typify = 전형적이다 / 특징이다
stimulus = 자극제, 자극(이 되는 것) / (생물에게서 반응을 유발하는) 자극
sucrose = (화학)수크로오스, 자당
mescaline = 메스칼린(로포포라 선인장에서 추출한 환각물질이 들어 있는 약물)
anecdotally = 일화로, 이야깃거리로
paucity = 소량; 부족, 결핍
reinforcement = (특히 감정, 생각 등의) 강화 / (군대, 경찰 등의)증강 병력
stand in st = (~를) 대신하다
erratic = 불규칙한, 일정치 않은, 변덕스러운 / (빙하에 의한) 표석
connotation = 함축(된 의미)
nasal = 코의, 콧소리의
sinus = 부비강(두개골 속의, 코 안쪽으로 이어지는 구멍)
anomaly = 변칙, 이례
undulate = 파도 모양을 이루다
W/W = weight for weight
phthalate = 프탈레이트(플라스틱을 부드럽게 하기 위해 사용하는 화학 첨가제)
botanical = 식물(학)의
conservative = 보수적인/ 영국 보수당의 / (실제 수나 양보다) 적게 잡은
tie = (강한)유대 관계
heterogeneity = 이종, 이류, 이질성, 불균질; 이류 혼교, 이질 성분
endorse = (공개적으로) 지지하다 / *유명인이 광고에 나와서 특정 상품을) 보증하다 / (영국) (운전 면허증에) 위반 사항을 기입하다
determinant = 결정 요인
normative = 규범적인
retrieve = 되찾아오다, 회수하다 /(정보를) 검색하다/ (좋지 않은 사태를) 수습[개선]하다 ; (잃은 것을) 되찾다
perimeter = (어떤 구역의) 주위[주변]
schematically = 개요로 ; 도식으로, 도표로
radially = 방사상으로; 반지름 방향으로
mean coordinate = 평균 좌표
nomothetic = 입법의, 법에 입각한 ; 보편적[과학적] 법칙의
posit = (주장 논의의 근거로 삼기 위해 무엇을) 사실로 상정하다[받아들이다]
stringent = 엄중한 / 긴박한, 절박한
elude = (교묘히)피하다[빠져나가다] / (무엇을) 이룰[이해할/기억할] 수가 없다
impair = 손상시키다
fluorescent = 형광성의 / 화사한, 선명한 ;야광의
on balance = 모든 것을 감안할 때
rule st out = (가능하거나 적절하지 않다고) ~을 배제하다 / (~하지 못하도록) ~을 제외시키다
anthropomorphic = 의인관에 따른(신, 동물, 사물을 의인화해서 보는)
magenta = 자홍색, 마젠타색
anecdotal = 입증되지 않은, 일화적인	
indifference = 무관심, 무심
dissipate = 소멸되다, 소멸하다/ (시간, 돈 등을)허투루 쓰다
inconclusive = (확고한 결정, 결과에 이를 정도로)결정적이 아닌, 결론에 이르지 못하는
temperament = 기질 / 신경질적임, 괴팍함
ideate = ~을 관념화하다 / 관념을 갖다, 생각하다
forge = 구축하다 / 위조하다/ (서서히 힘 있게) 나아가다 / 대장간, 용광로; 제철소
stocene = (지질) 홍적세 : 신생대 4기의 첫시기
indigenous = (어떤 지역) 원산의
banana spider = 호랑거미
abdomen = 배, 복부 / (곤충의) 복부
a fortiori = 한층 더 강력한 이유로
cie = 국제조명위원회
introspect = 내성하다 / 자기 반성하다, 내관하다 / 자기성찰하다
resemble = 닮다, 비슷[유사]하다
taut = (군더더기 없이)깔끔한, (밧줄 따위가) 팽팽한, 팽팽하게 긴장된
inhomogeneity = 이질(성), 불균등(성)
chromatic = (광학)유채색 / 염색성의
chiaroscuro = (미술) 명암 배분[대비]
entrenched = 참호로 둘러싸인; 견고한, 확립된
chroma = (색의) 채도
subtend = (기하) (현, 변이, 호, 각에) 대하다/ 대응하다
aperture = 구멍 / (카메라의) 조리개
wilted = (채소를) 살짝 익힌 [데친]
wilt = (화초 등이) 시들다, 시들게하다/ (사람이) 지치다, 처지다, 풀이 죽다
enterprise = 진취성,기획력 / 기업,회사, (모험성) 대규모 사업/ 민간 산업
starkly = 순전하게, 완전히
stark = (아무 색채나 장식이 없어) 삭막한, 황량한 / 냉혹한 / 완전히 벌거 벗은
prototypical = 원형의, 모범의
mottled = 얼룩덜룩한
stucco = 치장벽토 / 회
hunter-gatherer = 수렵 채집인
ambient = 주위[주변]의 / 잔잔한, 은은한
vertebrate = 척추동물
pathogen = 병원균, 병원체
fitness = 신체 단련, (신체적인) 건강 / 적합함
outline = 개요를 서술하다/ 윤곽을 보여주다[나타내다] / 개요
in that sense = 그러한 점에서/ 그러한 면에서
potency = 힘, (약 등의) 효능
contingent on = ~의 여부의 따라 / (어떤 행사에 참여한, 특히 출신지가 동일한) 대표단/ 분견대, 파견대